111111111111111111
1CCCCCCCCCCCCCCCE1
1CCCCCCCCCCCCCCCC1
100000000000000001
1000000P0000000001
100000000000000001
100000000000000001
100000000000000001
100000000000000001
100000000000000001
100000000000000001
100000000000000001
100000000000000001
100000000000000001
100000000000000001
1SSSSSSSSSSSSSSSS1
1SSSSSSSSSSSSSSSS1
111111111111111111