1111111111111111111111111111111111111111111111111
10P00000000000C00000000000000000000000000000000E1
1111111111111111111111111111111111111111111111111