111111111111111
10E000000000001
1C1000000000001
1C1000000000001
1C0000000000001
1C0000000000001
1S0000000SSSS01
1111111111111111