111111111111111111
100000000000000001
100000000000000001
100000000000000001
1000000PE000000001
100000000000000001
100000000000000001
100000000000000001
100000000000000001
100000000000000001
100000000000000001
100000000000000001
100000000000000001
100000000000000001
1CCCCCCCCCCCCCCCC1
1SSSSSSSSSSSSSSSS1
1SSSSSSSSSSSSSSSS1
111111111111111111