1111111111111111111111111111111111111111111111111
1S1S1S1S1S1S1S1S1S1S1S1S1S1S1S1S1S1S1S1S1S1S1S1S1
1000000000000000000000000000000000000000000000001
1000000000000000000000000000000000000000000000001
1P0000000000000000000000000000000000000C0000000E1
1000000000000000000000000000000000000000000000001
1000000000000000000000000000000000000000000000001
1S1S1S1S1S1S1S1S1S1S1S1S1S1S1S1S1S1S1S1S1S1S1S1S1
1111111111111111111111111111111111111111111111111